***********
*    *    *
*    *    *
***********
*    *    *
*    *    *
***********

******
*    *
*    *
******